########################################################################
#                           #                                          #
#                           #                                          #
#                           #                                          #
#                           #                                          #
#                           #                                          #
#                           #                                          #
#                           #                                          #
#                           #                                          #
#                           #                                          #
#                                                                      #
#                                                                      #
#                                                                      #
#                                                                      #
#                                                                      #
#                                                                      #
########################################################################
